NO 			./textures/bluestone.xpm


		 	 	 	 	 	 	 	 	                  SO ./textures/greystone.xpm
WE 	./textures/eagle.xpm
EA ./textures/redbrick.xpm
C 65,240,255
F 71,19,0000021


11111111111111111111111111111111111
100000000010000000000000000000000001
100000000010000000000000000000000001
1000000111000000000000000000000000001
1000E0000000000000000000000000001
10000001110000000000000000000000001
100000000000000000000000000000000001
100000000000000000000000000000000001
111111111111111111111111111111111111
11111111111
10000000011
11111111111